2
E V M V T
. . . . .
. . P . .
R . . . .
M . M . P
