2
E . . P .
. M . . .
. . T . .
. . . R .
. . . . P
