3
E T M . T
. T . P .
. . . R .
M . P . M
R . . . P
