2
E . M V T
R . . . .
. . T . .
R . . . .
P . M . P
